111111111111111111
10100E000000000001
100000000P00C00001
101C00000010000001
100000C00101010001
111111111111111111
