11111111111111111111111111
1P100000000000000000000001
10101111111111111111111101
10101EC0000000000000000101
10101111111111111111110101
10100000000000000000000101
10111111111111111111111101
1000000000C000000000000001
11111111111111111111111111
