111111111111111111
101C01000000000001
100P0E000100100001
101101100010000001
100C00100101011011
111111111111111111
