111111111111111111
100000000000000001
10C0000E0P00000001
1000E0000000P00001
111111111111111111
