111111111111111111
100000000000000001
1000000000V000E0P1
10000C0C0000000001
111111111111111111
