111111111111111111111111
100000000000000000000001
000000000000C0E0P0000001
100000000000000000000001
111111111111111111111111
