1111111111111
10000000001
10P0E0C000001
1000000000001
1111111111111
