111111111111111111
100000000000000001
1000000E0000P00001
100000000000000001
111111111111111111
