1111111111111111111
1P000C0000000010001
10010000000000100E1
1111111111111111111
